.OO.....O..O.O.O.O..
.OO......O....O...O.
O.....O.OOO...O.O..O
O..OOOOOO.OOOOO..OO.
..O.O...O.OO...OOO.O
O.O...O..OO..O...OO.
OO.OOOOOO..O........
...O.O.O.O.OO...OOOO
OOO..O..OO.O.....OO.
OO.OOO..OO.O.O..OOO.
OO...OO..OOOOO...O.O
.OOOOOO..O.O..OO.OOO
..OOOO.O.O.O.OO..O.O
...OO.OO.O..O..OO.OO
OO..O....O...OOOO..O
O..OO...O.O.OO......
.O.O..O.O..OOO..O.O.
.OO..O..O.O.OOOOOOO.
O.OO.OO...OOOO..O...
..OO.OO...OO.....OOO
